0000000000
0000000000
0000000000
W000B00000
0000000000
0000000000
00B0000W00
0000PQ0000
0000LRUU00
UUUUUUUUUU
