0000000000000000000000000000000
0000000000000000000000000000000
00U000000000000000000000000B000
0000000000000000000000000000000
000000000000000000000UUUUWWWWW0
W000B000000000000000U0000000000
0000000000000000000U00000000000
000000000000000000U000000000000
00B0000W000000000U0000000000000
00000000PQ00W000W00000000000000
W00M0000LR000000000000000000000
UUUUUUUUUUUUUUUUUUUUUU000UUUUUU
