0000000000000000
0000000000000000
0000000000000000
W000B00000000000
0000000000000000
0000000000000000
00B0000W00000000
000000000000W000
W0M0000000000000
UUUUUUUUUUUUUUUU
